#
# ▓▓▓▓▓▓▓▓▓▓▓▓▓▓▓▓▓▓▓▓▓▓▓▓▓▓▓▓▓▓▓▓▓▓▓
# ▓                                 ▓
# ▓   ▓▓▓   ▓  ▓ ▓▓▓▓▓ ▓▓▓▓▓ ▓▓▓    ▓
# ▓   ▓  ▓  ▓  ▓   ▓     ▓   ▓  ▓   ▓
# ▓   ▓  ▓  ▓▓▓▓   ▓     ▓   ▓▓▓    ▓
# ▓   ▓  ▓  ▓  ▓   ▓     ▓   ▓      ▓
# ▓   ▓▓▓   ▓  ▓   ▓     ▓   ▓      ▓
# ▓                                 ▓
# ▓▓▓▓▓▓▓▓▓▓▓▓▓▓▓▓▓▓▓▓▓▓▓▓▓▓▓▓▓▓▓▓▓▓▓
#
# hello-world example app config file
#

HOSTNAME="hello-world.akd.sh"